R 2147483647 2147483647
NO ./pics/redbrick.xpm
SO ./pics/greystone.xpm
WE ./pics/wood.xpm
EA ./pics/colorstone.xpm

S ./pics/barrel.xpm
F 63,155,11
C 77,143,172

        1111111111111111111111111
        1000000000110000000000001
        1011000001110000000000001
        1001000000000000000000001
111111111011000001110000000000001
100000000011000001110111110111111111111111111111111111111111111111   111111
111100000111110111000000100000000000000000000000000000000000000001   102011
111100000111110111010100100000020000000000000000020000000020000001   111111
110000000001010000000000000000000000020000000000000000000000000001   111111111
100000000000000000000000000000000000000000000200000000002000000001   10001 111
100000000000000011010100100000000000000000000000000020000000000001   1111111111
11000001110101011111011110N00000000000000000000000000000000000000111
11110111 1110101 1011110100011111111111111111111111111111111111111
11111111 1111111 111111111111
                             
11111111111111111111111111111
10000000000000000000000000001
10000000000000000000000000001
10000000000000000000000000001
11111111111111111111111111111